[MAP_WIDTH]
320
[MAP_HEIGHT]
320
[SPRITE_ID_CELLS]
97,98,97,98,97,98,97,98,97,98,97,98,97,98,97,98,97,98,97,98
109,110,109,110,109,110,109,110,109,110,109,110,109,110,109,110,109,110,109,110
97,98,97,98,97,98,97,98,97,98,97,98,97,98,97,98,97,98,97,98
109,110,109,110,109,110,109,110,109,110,109,110,109,110,109,110,109,110,109,110
97,98,97,98,77,77,77,77,77,77,77,77,77,77,77,89,97,98,97,98
109,110,109,110,77,77,77,77,77,77,77,77,77,77,77,89,109,110,109,110
97,98,97,98,103,103,103,103,103,103,103,103,103,103,103,104,97,98,97,98
109,110,109,110,103,103,103,103,103,103,103,103,103,103,103,104,109,110,109,110
97,98,97,98,103,103,94,94,94,94,94,94,94,94,103,104,97,98,97,98
109,110,109,110,103,103,94,94,94,94,94,94,94,94,103,104,82,71,71,72
97,98,97,98,103,103,94,94,103,103,103,103,94,94,103,104,82,71,71,72
109,110,109,110,103,103,94,94,103,103,103,103,94,94,94,107,109,110,109,110
97,98,97,98,103,103,94,94,94,94,94,103,103,94,94,107,97,98,97,98
109,110,109,110,103,103,94,94,94,94,94,103,103,103,103,104,109,110,109,110
97,98,97,98,103,103,103,103,103,94,94,103,103,103,103,104,97,98,97,98
109,110,109,110,103,103,103,103,103,94,94,103,103,103,103,104,109,110,109,110
97,98,97,98,97,98,97,98,97,95,95,98,97,98,97,98,97,98,97,98
109,110,109,110,109,110,109,110,109,95,95,110,109,110,109,110,109,110,109,110
97,98,97,98,97,98,97,98,97,95,95,98,97,98,97,98,97,98,97,98
109,110,109,110,109,110,109,110,109,95,95,110,109,110,109,110,109,110,109,110